**********
*P    *  *
*        *
*        *
*   * *  *
*     E  *
*        *
*        *
*  *    G*
**********